0 1 1 1 1 1 1 1 1 1 
1 2 2 2 2 5 2 2 2 1 
1 2 2 2 2 9 2 2 2 1 
1 2 2 2 2 6 2 2 2 1 
1 2 2 2 3 6 3 2 2 1 
1 2 2 2 3 7 3 3 2 1 
1 2 2 2 2 3 3 3 2 1 
1 2 2 2 2 3 3 3 2 1 
1 2 2 2 2 3 3 3 2 1 
1 2 2 2 2 3 8 3 2 1 
1 1 1 1 1 1 10 1 1 1 
1 4 4 4 4 4 4 4 4 1 
1 4 4 4 4 4 4 4 4 1 
1 4 4 4 4 4 4 4 4 1 
1 4 4 4 4 4 4 4 4 1 
1 4 4 4 4 4 4 4 4 1 
1 4 4 4 4 4 4 4 4 1 
1 4 4 4 4 4 4 4 4 1 
1 4 4 4 4 4 4 4 4 1 
1 1 1 1 1 1 1 1 1 1